ADDDDDDDIDDIDDDDDDDF
BLKKKKKKBNNBKKKKKKLB
BKADFKBKBNNBKBKBKBKB
BKBNBKBKBNNBKBKBKBKB
BKBNBKBKCDDEKBKBKBKB
BKBNBKBKKKKKKBKBKKKB
BKCDEKHDDDDDDEKBKBKB
BKKKKKBKKKKKKKKBKBKB
BKADFKBKADFKADDEKBKB
BKBNBKBKBKBKBKKKKKKB
BKBNBKKKKKBKBKDDDDDG
BKBNBKBKBKBKBKKKKKKB
BKCDEKBKCDEKCDDFKBKB
BKKKKKBKKKKKKKKBKBKB
BKADFKBKADDFKBKBKBKB
BKBNBKKKBNNBKBKBKKKB
BKBNBKBKBNNBKBKBKBKB
BKCDEKBKBNNBKBKBKBKB
BLKKKKKKBNNBKKKKKKLB
CDDDDDDDJDDJDDDDDDDE

9 9 2 1 10 8